NO textures/winter_forest.png
WE textures/winter_forest_2.png
EA textures/winter_forest_3.png
SO textures/winter_forest_4.png

F 255,255,255
C 135,206,235

1111111111111
1000000000001
1000100010001
1000000000001111111
100000S000000000001
1000000000001111111
1000100010001
1000000000001
1111111111111
