
NO textures/winter_forest.png
WE textures/winter_forest_2.png
EA textures/winter_forest_3.png
SO textures/winter_forest_4.png

F 255,255,255
C 135,206,235

11111111111111111111111111111111111111111111111111
10100000000000000000000000000000000000000000000001
10100000100000000000100011010000010000000000010001
10101010101111111010111011010111010111111101011101
10101010101111111010111011010111010111111101011101
10001010001000101000101011000101000100010100010101
10001010001000101000101011000101000100010100010101
11111010111110101110111011111101011111010111011101
11111010111110101110111011111101011111010111011101
10000010100010100000100011000001010001010000010001
10000010100010100000100011000001010001010000010001
10111110101110111111111011011111010111011111111101
10111110101110111111111011011111010111011111111101
10100000101010000010100011010000010101000001010001
10100000101010000010100011010000010101000001010001
10101111101011111010111011010111110101111110101101
10101111101011111010111011010111110101111110101101
10101000101010001010100011010100010101000101010001
10101000101010001010100011010100010101000101010001
10111010101010101010111011011101010101010101011101
10111010101010101010111011011101010101010101011101
10001010101010101000100011000101010101010100010001
10001010101010101000100011000101010101010100010001
11101010111010101110111011110101011101010111011101
11101010111010101110111011110101011101010111011101
10001000100010001000100011000100010001000100010001
10001000100010001000100011000100010001000100010001
10101111111111111011111011011111111111111110111101
10101111111111111011111011011111111111111110111101
10100010001010001010100011010001000101000101010001
10100010001010001010100011010001000101000101010001
10101111111111101010111011011111111111110101011101
10101111111111101010111011011111111111110101011101
10001000010000001000100011000100001000000100010001
10001000010000001000100011000100001000000100010001
10111011101111111110111011011101110111111111011101
10111011101111111110111011011101110111111111011101
10101010101010101010101011010101010101010101010101
1N101010101010101010101011010101010101010101010101
11111111111111111111111111111111111111111111111111